1111111111111111111111111111111111111111111111
1340310014300212210221324110000444113003423341
1032300101202040102140400441000111414203003041
1320310440100300241343441004320431410002113421
1221224130043243123004120340004400034332420431
1204043023430320321003004012010132244402420101
1331322004201203040400000101032134111244024131
1231403143024013300131140000314400301400420201
1211223214012401001030002240220321030404104401
1024102142114040040002003000111021010404020341
1232102240400002000104002440400400032110324311
1044042201401014020011000001400300203012242331
1324204320114043032020000034322430404203113221
1141401404413344204020000404000033101401224021
1412440430424304000004000200040000043222011421
1344004143000114000020400001040000334201201411
1033400033010200002000000000040020200401123341
1403131140003300100000000000000100002000230021
1040324300100220440000000000000002034302313001
1002004000020302000000000000001030211013304301
1121200132002003000000000000000040001041400121
1100443400000000000000000000000000004400322401
1242030040040044000000000000000000000011014211
1003042002000000000000000000000003400024402411
1144002424020000000000000000000103300041233101
1330404042400000000000000000000000002241043001
1133201000034001000000000000000000040210001031
1321400021002000000000000000000000120304123321
1443443004014003000000000000000012001443413441
1014204400200300000000000000034000000402331231
1030300143303113400400000000040020000320220341
1144030014140002040004200020000420013110021031
1423420401343100000004030300000041204203421131
1003040100100004210200300002010000430343022131
1332200332020022002410010004002020400143421421
1023231444030144010004000030204013020210401121
1413421244420003300010000300403000000420223041
1230022311320320102400423400301022404401324021
1100244000340042130104400400010312311221113421
1434244114002104430202300030043141030301042211
1233002404121300401030000001200301240221314411
1022004002002044002330013100302140043412313131
1343434022103014142102400104304034102430302231
1011032002140142032124400002104033221010141141
1223422233321110040031244020030204022242130031
1111111111111111111111111111111111111111111111
