1111111111111111111111111111111111111111111111
1103304404402113001324004440002323412210324421
1203130220234443424001202001000124010043102431
1002210143043001044210210110404140433002423011
1444214000200201212420144014012000142211031001
1300313042312201004100014202334022402040400411
1324213310013420043300200033323031440044311301
1124201020421304040012040000000233000344132111
1134120420001310401400000432344040223303441121
1314300301310314410200003040024241410304133241
1212423302344034000020430440401124021304422401
1102002223230014144001001020301000002203103031
1233330230040000002100230003102244200302033441
1302030244430222420023000004401000004001100131
1002140144310231004000100440000003304020331401
1000320400401100004000020004304010004240000021
1441221041040000000000000000000004104100100301
1303243400000100000000000000020040303112010231
1104032420103010000000000000000100000003434041
1030030331004300000000000000000044440404014211
1342020010000001000000000000000001041003102031
1242430222102200000000000000000000002420001431
1423403110443000000000000000000020033042042431
1042010444400003000000000000000004200340031201
1404003023002400000000000000000010300303240431
1340011040401003000000000000000004000012314221
1341323202024430000000000000000000030020010101
1022011000440400000000000000001010414332120221
1012240000000000230000000000000023000040320311
1201120201000320000000000000000000000320030301
1243024400002000100300000000004003000142010041
1243404043004000004030000304031044300133212241
1311331104300002020040021000000130032124342211
1314400324403011040020104001400204300341134041
1242001044300002420434141000001002040030241021
1122241002004021440040110100003231200110021231
1212014200121320220200001000030010202334432121
1300124302000324020004000010412022200040342441
1124110000020324020000400102030400003130220031
1214421003003023400330012400012010223111310101
1004433300104033424104020044000103240112200241
1331013330041201410211024230034201022301324011
1014214211443431424430330042024201320103020011
1142323112434100220040021410204100041441431411
1231110421030442412221434424011000443144440101
1111111111111111111111111111111111111111111111
