1111111111111111111111111111111111111111111111
1111200100103403000001222101412100031214004231
1400403003233004244121444324001124013301404221
1200232023231010022010020444022203412013234401
1024034214000100001033004330042234004121041101
1324101204403401120313021000011240201241012121
1021002432124242400004003043201200223202040111
1132003011314402103104034300000420042204131241
1300213212003404022402200211102013144020311431
1410333313021000002000404021024000041304002201
1200114003000320400033340210442430000002130141
1004043311100004210010000000002201210044312211
1202233414303430000040220002040110040114034411
1330343003134104040002030310220000201103003411
1424424201110410030100000000010020000032320131
1234234304024304000000000003120324000040200121
1144212223140143002200000000020020344100110011
1320202310000010430000000000003033010410203201
1000221100004000000000000000004430340001234241
1244303220400040000000000000004004040302000311
1122110400000300000000000000000300210011402301
1220220220413000000000000000000104034411441101
1212023022420322000000000000000000402200323101
1404344031104200000000000000000000342001441421
1113332021021000000000000000000004022234113241
1124131300320302000000000000000200003101342231
1432002011001330000000000000000003203420403021
1004230040004040000000000000003024014004242101
1231400232423040000000000000000200444000002321
1412441001210000000000000000002004004020011321
1330232404040000100000000000004200321114020441
1400304303340032100000020400000000131041133211
1003401302300300030304410000000000304323020221
1033314213000020400000000403000023402013010101
1144002234321040041000000000000040100032421331
1112201213320103040002200400210003230030141401
1011240204104112001300033002011240031030143321
1032414223001002200000002230201220044440200011
1311132320003224001020014130220321411404311121
1032402133124224221003010100000240312411042311
1220434242030304230414032231443401204143401321
1004231400344124020003300414110000041111410421
1233303334303340103311040030022000010110440321
1240014104330013144130022042312144102444201121
1104441334104223004230210112433013100400444401
1111111111111111111111111111111111111111111111
