1111111111111111111111111111111111111111111111
1011002113031022103410010010040230321041022201
1041332131101104012340004401111231320341134241
1432144430301324000010203301212300043223021021
1040431432342113224320300304040131423141002441
1333313414121100130141000010220442123141040241
1330321214001434203110002000012113003010214231
1222111142040000030242400110142000030030224331
1114200120024002020000004024200244300444140321
1201442424221323204040000000302331311204000241
1120331120303001001330000302000021420233301401
1131242444424220020300001000000340303322420141
1010401032220430044004303010400130324244344111
1321244131034000000000020001023000003304043041
1101200402043010040002102003030000120331014431
1312030110011002302000003200000041021412404441
1001300010300000000000000000200031023412432421
1321024400300100000000000000030300001202021441
1440220023022001000000000000000000040020000141
1311343041240300000000000000000020104130112321
1202410342100001000000000000000400000124234431
1341000000230300000000000000000020021110430031
1202400414102400000000000000000040010043002401
1301302304400200000000000000000000100134041201
1044001000000000000000000000000003000140044111
1224401031000300000000000000000200001014222131
1130110401041012000000000000000230040002023431
1100010324000000200000000000004001200033103441
1302310413320000000000000000000310044044204211
1101000202400020003000000000001033314213112011
1411244202002000000000000000001000000041044221
1141344300044100000000200004032002000224200331
1314023341003402100020000320100100134101021241
1000002021010311400020000000000021020044400311
1341333020020000303400300410140131000102002041
1431031102243044002010003000002000024001403301
1011242020231011330300101000231003020432401011
1003301120344140043103000004004101412140440211
1020033332102001011100241040000034110023223221
1201101324201310344000320400003004312004013111
1431022233202014011000440411312100322210014241
1023200110001404202320424300003242002304032031
1131141400433011340434100243132034311244032241
1401013414100401200000143131420002120443010331
1442304402001204241300310101114100043442104401
1111111111111111111111111111111111111111111111
