1111111111111111111111111111111111111111111111
1224101001110411434010040000102033223022130201
1341111013000202131244044344400002024404022321
1301324242243442033340102130340102123341203131
1400003012021033200000412003011214011003424001
1440313421421344042032144403003044204223131021
1204244402013231340330403104022201323024011121
1141320143042020000400000444044043002201033431
1032404220040341000402302100310200423000443101
1040100243201300124200010000400313430431322001
1014211000104222030000202231003011301143303141
1231010344001000202000000204204011130013310201
1440314204310200240000400300000030132002020131
1103112004300003001000000000042031020013442321
1134001010420404001000400000310100404400121301
1303112124013043003010000000001114300100434041
1221230331200000230100000001000101130033144401
1411103012010200002000000000000010303312032421
1330040020003000400000000000000014202023021111
1323010031004204200000000000001000002200401041
1000023201220040000000000000000000032040204201
1122130000040002000000000000000010000200400341
1110110040000110000000000000000300000040001311
1200002142002314000000000000000000040034140231
1210433400000000000000000000000000010002420011
1230304142003001000000000000000100020000012241
1014330000004000000000000000000003040322241311
1321042041324110000000000000000001040401011111
1413142001004000040000000000044000102300023441
1422213011100003000000000000102112020131123401
1033114024440400000100000000000040002410000311
1410040204020313000240030004010410000004111321
1330203400100200100004000000010000400204411021
1021132301000322240132001031042300143100133141
1234320304100123203020032400004030404441020311
1040323200202200030404310200014103320344410101
1101322241400100300040300111000003012004243231
1002402320413121010001400313000021014424244221
1014130232442000221201330030420044204112120441
1421322140001310014300002300220003104120341131
1244012234040021214004033011303320310340400431
1221012224124401202400004040434403012044323021
1302010441004420023021200044421011001432020331
1432401222443200321011400423101244033204343011
1411020033212020001011102011000242230240430331
1111111111111111111111111111111111111111111111
