1111111111111111111111111111111111111111111111
1413300444404340402240202242200302434221013121
1213111043242340101204401304300404320223410001
1403414302403022434330104034212412340311134211
1412400220203142040100013004430110003124242101
1242303113434012000334000443414041042010233341
1101333424032022200001040010142023111141012201
1400200132043033233024100002420000340240142031
1232122134400100400001424104030001424142202441
1230223313142020340300120102400103012002044031
1030003203010300000414004004030002004114040031
1101404034444002040000004002110220010102004101
1120331203234214044200000002004302432023240221
1041214330002200031000024010103100341120032231
1302230430013020040100030000402010400013020141
1412244330000203202020000002000000042014344201
1144131040341000001000000000000000042041104021
1410412122030100014000000000000000330304224441
1003444200442040000000000000004310101000101311
1042301000301023000000000000002000131311100101
1010413401034230000000000000000000000011413311
1212311002400400000000000000000003000140104401
1114100322400000000000000000000000043001204111
1421242001310000000000000000000000110311400431
1010311030200030000000000000000403002404002001
1100341204000000000000000000000000120100243021
1312042321031000000000000000000000234410431111
1413243104400014100000000000000002000000212001
1042331010021400040000000000000403230004100241
1014103441300003000000000000002000003300000341
1333441203200004010000000000031400120334134221
1400013140043210400000000000000140130304421401
1321124114034001013000000044011012101103140101
1223030312000020030110420100044300000202220001
1210141040300000400200100043020102001000024021
1440113012420100300200010040430132330012304211
1020204022103243010300040410201000344040001111
1123042040244000030010200000410031331111021141
1311030443120023004332020104033040330040222331
1240132041303000401210000110231033043201224201
1132024310332431120400303404223302014110203241
1214302434242243134221030304031420021440212201
1312212110400040013031242034300033012021114401
1013101003044400332040400041120020233021231141
1440410143211044401420030013301033023010043231
1111111111111111111111111111111111111111111111
