1111111111111111111111111111111111111111111111
1022010400010240041002100020340130014401242201
1010142022304414300230402012411004033431443331
1344202000424240404400233001240140141013401431
1412002344414244002400041002140111300110424431
1143032331200234424010340100213300340420343301
1443321211331402420400000141340040104420412411
1230342110300000134330200120000000142030020311
1040344001414222301031110000213122044440212021
1014122233112233022402010400042020000023400141
1130104024010004201023000140030004034140224231
1024313410030032242210000002000032233212032201
1020400044101434410002202040000304102140301031
1211430321120030421300000002400341021430400401
1302204401400202000400010010000000220032044211
1200141002004000100022000000101100140421124031
1334324400021002003000000002011204003442313221
1102224400024001000000000000100000400001434241
1131142432204400000000000000040000004331200321
1120343204240102000000000000002012013402432311
1222340400000000000000000000000140001211124031
1224223442030000000000000000000230024102104241
1220010103000001000000000000000200414300130401
1203440404000100000000000000000000000001240211
1332301124220300000000000000000000000040344021
1414024444000040000000000000000041020112233021
1220310110220000000000000000000300001333300301
1322040023200400000000000000000023000110214021
1220430010230041010000000000001440200233403011
1212410101401002100000000000000430034130013301
1211401300200300000000000000002010010002210331
1001002333104444000413310000000023420203430201
1132212401400030400001020034400000002141001001
1310433021101410000001001003040000000140421241
1130111414330300220210001100040032114402240031
1341111340001134401040210200010003110200444321
1000024021240203010030100400102044400130120341
1132003002300004000000430000003011213232021041
1002231220001002232002200240401403412103411121
1314042103201040001030333041243140212011342131
1401442140100100004003030200411410100021121001
1312222430423001010230003024210302400143034331
1121130213110224030004004030304332232343040141
1221040334124100204120403430244121002443224011
1201122220434002314434303302000331230221314141
1111111111111111111111111111111111111111111111
