1111111111111111111111111111111111111111111111
1010004202033101133320101024101204222440102321
1232011000304041433403433304010404040332423201
1110431211240044040024230002244243241444211301
1120320202303420410001111244410402120422442221
1301140424312022010044440030303202410024120401
1031441422440214020013021010303230001320114031
1302040221304211200001000001104122044434432301
1400410001100102104000000400404102332344311311
1432221233301031320041023200400030412003433311
1211412423010100220013403001030014240241103411
1323334001430230400030004040120000000044410431
1320001000402000200103010000222004304100302311
1223403130400100000000430010003300403033430411
1322132014000113300000000000003011010003204001
1314100421043302002004403010001012004034100441
1214044243200300000000000000030234042002400101
1430102230110010000000000000420000030334013241
1011334121200000000000000000000002024200002001
1103033200420400300000000000000001312440342341
1120040400000201000000000000000400000043411031
1104140040000100000000000000000220001112220011
1144010240000000000000000000000001034003041301
1030440323400000000000000000000000000240134011
1343024000003304000000000000000320100241330011
1112300102020300000000000000000300433000003421
1131432001004204000000000000000000000400021331
1014201033020302000000000000000000000030212121
1202304000004000100000000000003434004010213011
1300220122203001000000000000001030000202003021
1000004434014040012000000004000003010202003441
1240434330313400000002004003004001000201210221
1020201342100030120000140000111100014343440441
1340342430110400000000021022043002001241214031
1010304340241012142302104300441400221420040121
1113003014224320020031404001200240430224334341
1204340024310211001000020000034300102002032431
1440340334034003000000000040112200323102443031
1411040102223001010404000021011002000312410441
1440124232111402013014330032002014311021142221
1321403003404020230342300000003404034302224101
1324422123020430300110404210100124022030012211
1120100130213441430140204003013201414032444221
1442001433200312411334310144044120000222021041
1330404103221044130040400010421401324002140031
1111111111111111111111111111111111111111111111
