1111111111111111111111111111111111111111111111
1404320123010314140234344403301344412200424231
1003223343113002241304203330423202101320322111
1243102300343334242000033120100400141204224221
1412233411340004202030400143314132000140311131
1302140402020410041031042004142204034243422101
1342230121044303004103040231104400231234242121
1103430400001402130014033040010312331003231211
1314123302033320000304000100000002004034414401
1231440120033401100000000401004110241023000321
1403120042223300400200000020000000224101020101
1311032140210402234022000002001040002002042211
1014042031141000040300000040311000003101041321
1204411041243111022003002020000200401403213141
1304001021410023040000040041010112030122304101
1302440043020004100400300000020000004404013241
1040312201022003000000000000004011103014310431
1340233003010000420000000000200000400443204311
1401041314002434200000000000000404000113003341
1310340100400403000000000000003400040433222011
1021114301231040000000000000000000220224044401
1330413020000200000000000000000000013004030121
1003143002012000000000000000000210000000404411
1431003201100002000000000000000000003400104341
1132331433143040000000000000000000040040010441
1320011110201000000000000000000000024111014041
1400020124102004000000000000000010002203423231
1024044301000003000000000000000020000000120021
1001244130304303010000000000002003004000231031
1313410020000030400000000000030302020442130111
1200000104004441200000000000400000003444233421
1203431121144004000000000000021420130010001041
1211214312012104000040010000004000030310232411
1340224010004014220003200300010000303201322021
1012412200010030040040033000000040032221101441
1404240221002201204332000302000401023242033411
1224000141232000003002003142044313004120024141
1134443042223100330020000100203110001001222111
1244243041040131340040230244101301420004230131
1113413403303413032224000202033221230033313041
1132334002013210421012444040003112030230311121
1014411430000334012001200213402200442011022221
1200103330404130043130140103330333303130411431
1233043204433324102000234202020200441102300221
1141104444032122444024100034210103321103014121
1111111111111111111111111111111111111111111111
