1111111111111111111111111111111111111111111111
1211324403440120420201330010400310434133110041
1214104113304304000000343113111044002011434411
1241130110041213131432140020312113214200403101
1441441024223004040200034230213000404231432401
1300304430134030242100430001032400400201304201
1124412111022430020340001204122302012424304341
1401014101210044400302140403000012302232123041
1231412420401401011041400000302220230240304341
1020120234302140040000043000130032003134001301
1412114140033030010010000032012404010133134201
1101332101210101004100004022300400204000433221
1130234100002411400130004001041000211300401041
1433304232311001000000000300423201100332011301
1112011331210020030000000000200201140012044131
1012124103100140400010010000102324040403433031
1220002101040000400000000003300020003301023421
1310143344000402000000000000221000142011043001
1103113000020003000000000000000000110133004331
1001103034020030000000000000000000214430222221
1011000001020000000000000000000001004012341031
1024341001300030000000000000000000420200140441
1041010144000401000000000000000001201200203031
1102300423030030000000000000000001020300341401
1411422304400101000000000000000040044033000031
1001024032010000000000000000000003043003042401
1232402300011040000000000000000400200444021111
1201224100040003000000000000000441004000400111
1020021243432023420000000000030014020130003431
1110132300400200200000000000200000000302211411
1004433404000412200000000000040000202400214401
1140240202444003330200004000300302221443220431
1144040330330002000000000100001014011420322101
1233021030000040020040300202403002413400222011
1320221210310040030004003000000021211222342011
1203020101033200000300000403104300230344001141
1211430340243003034010004100000000022021222011
1133143424130432410000004000104120300032110311
1403401430044134334020100001240014342212203401
1221411223144040002304000430002410000044323231
1042020041231110303030001011312303202003401111
1002320212424400340421240311413110000200431401
1433143442040200321030200210130002112321200221
1102124222402020440004341344414440302212430311
1100203313104210401110033100010330204410102331
1111111111111111111111111111111111111111111111
